"a" = (/turf/burning_ground,/area)

(1,1,1) = {"
aaaa
aaaa
aaaa
aaaa
"}
